{
  "e": "i",
  "t": "e1",
  "n": "Fq",
  "r": "Nq",
  "a": "ZK",
  "an": "Xu",
  "explained": "onNodesChange",
  "node": "map",
  "the": "used",
  "perpendicular": "direction",
  "expected": "render",
  "triangles": "defined",
  "$": "qC",
  "$n": "nu",
  "$t": "nd",
  "A": "RT",
  "An": "Tu",
  "Ar": "p",
  "At": "Td",
  "B": "Kw",
  "Bn": "hu",
  "Bt": "hd",
  "C": "vT",
  "Cn": "Mu",
  "Cr": "Ml",
  "Ct": "Md",
  "D": "JP",
  "Dn": "Ou",
  "Dr": "Ol",
  "Dt": "Od",
  "E": "J",
  "En": "ku",
  "Er": "kl",
  "Et": "kd",
  "F": "kO",
  "Fn": "bu",
  "Ft": "bd",
  "G": "sS",
  "Gn": "uu",
  "Gt": "ud",
  "H": "tw",
  "Hn": "pu",
  "Ht": "pd",
  "I": "Zw",
  "In": "yu",
  "It": "yd",
  "J": "Zb",
  "Jn": "su",
  "Jt": "sd",
  "K": "ww",
  "Kn": "lu",
  "Kt": "ld",
  "L": "qw",
  "Ln": "vu",
  "Lt": "vd",
  "M": "wL",
  "Mn": "Cu",
  "Mr": "l",
  "Mt": "Cd",
  "N": "VF",
  "Nn": "Su",
  "Nr": "a",
  "Nt": "Sd",
  "O": "tI",
  "On": "Du",
  "Or": "Tc",
  "Ot": "Dd",
  "P": "q",
  "Pn": "xu",
  "Pt": "xd",
  "Q": "GC",
  "Qn": "ru",
  "Qt": "rd",
  "R": "Lw",
  "Rn": "_u",
  "Rt": "_d",
  "S": "UO",
  "Sn": "Nu",
  "Sr": "Nl",
  "St": "Nd",
  "T": "sO",
  "Tn": "Au",
  "Tr": "Al",
  "Tt": "Ad",
  "U": "ZC",
  "Un": "fu",
  "Ut": "fd",
  "V": "kw",
  "Vn": "mu",
  "Vt": "md",
  "W": "HC",
  "Wn": "du",
  "Wt": "dd",
  "X": "Dx",
  "Xn": "au",
  "Xt": "ad",
  "Y": "IC",
  "Yn": "ou",
  "Yt": "od",
  "Z": "BC",
  "Zn": "iu",
  "Zt": "id",
  "_": "tU",
  "_n": "Ru",
  "_r": "Rl",
  "_t": "Rd",
  "ar": "Xl",
  "at": "W_",
  "b": "dT",
  "bn": "Fu",
  "br": "Fl",
  "bt": "Fd",
  "c": "tK",
  "cn": "qu",
  "cr": "ql",
  "ct": "qd",
  "d": "zG",
  "dn": "Wu",
  "dr": "Wl",
  "dt": "Wd",
  "en": "td",
  "er": "tu",
  "et": "JC",
  "f": "MG",
  "fn": "Uu",
  "fr": "Ul",
  "ft": "Ud",
  "g": "qU",
  "gn": "zu",
  "gr": "zl",
  "gt": "zd",
  "h": "xW",
  "hn": "Bu",
  "hr": "Bl",
  "ht": "Bd",
  "i": "jq",
  "in": "Zu",
  "ir": "Zl",
  "it": "UC",
  "j": "GE",
  "jn": "wu",
  "jr": "d",
  "jt": "wd",
  "k": "cO",
  "kn": "Eu",
  "kr": "ls",
  "kt": "Ed",
  "l": "VG",
  "ln": "Ku",
  "lr": "Kl",
  "lt": "Kd",
  "m": "LW",
  "mn": "Vu",
  "mr": "Vl",
  "mt": "Vd",
  "nn": "$u",
  "nr": "$l",
  "nt": "Rx",
  "o": "oK",
  "on": "Yu",
  "or": "Yl",
  "ot": "Jv",
  "p": "VW",
  "pn": "Hu",
  "pr": "Hl",
  "pt": "Hd",
  "q": "Ow",
  "qn": "cu",
  "qt": "cd",
  "rn": "Qu",
  "rr": "Ql",
  "rt": "Bb",
  "s": "iK",
  "sn": "Ju",
  "sr": "Jl",
  "st": "Jd",
  "tn": "ed",
  "tr": "eu",
  "tt": "WC",
  "u": "BG",
  "un": "Gu",
  "ur": "Gl",
  "ut": "Gd",
  "v": "XH",
  "vn": "Lu",
  "vr": "Ll",
  "vt": "Ld",
  "w": "xT",
  "wn": "ju",
  "wr": "jl",
  "wt": "jd",
  "x": "Y",
  "xn": "Pu",
  "xr": "Pl",
  "xt": "Pd",
  "y": "Mk",
  "yn": "Iu",
  "yr": "Il",
  "yt": "Id",
  "z": "Rw",
  "zn": "gu",
  "zt": "gd"
}